NO ./textures/stone.xpm
SO ./textures/cobbelstone.xpm
WE ./textures/obsidian.xpm
EA ./textures/bookshelf.xpm

F 111,78,55
C 173,216,230

        111111111111111111111111111
        1000000000110000000000001
        1011000001110000000000001
        1001000000D00000010000001
1111111100110000011100000000000W1
100000000011000001110111111111111
11110111111111011100000010001
11110111111111011101010010001
11000000110101011100000010001
10000000010000001100000010001    1
10000000000000000011010100101   1011
11000001110101011110111100011    1
111101110111011011011 1010001
11111111111111111111111111111