NO ./textures/stone.xpm
SO ./textures/cobbelstone.xpm
WE ./textures/obsidian.xpm
EA ./textures/bookshelf.xpm

F 101,67,33
C 173,216,230

        11111111111111111111111111
        1000000001100000000000001
        1011000001110000000000001
        1001000000D00000000000W01
111111111011000001110000000000001
1001  1011011000001111111111111111
11111111111111011100000010001
11110111111111011101010010001
11000000110101011100000010001
10001000000000001100000010001    1
1001 100000000001101010010001   101
110011011101010111110111100011   1
11111111 1111111 1111111111111