NO ./textures/stone.xpm
SO ./textures/cobbelstone.xpm
WE ./textures/obsidian.xpm
EA ./textures/bookshelf.xpm

F 220,100,5
C 225,30,12

        111111111111111111111111111
        10001000000110000000000001
        1011000001110000000000001
        10010000000000000000W0001
111111111011000001110000000000001
100000000011000001110111111111111
11110111111111011100000010001
11110111111111011101010010001
11000000110101011100000010001
10000000000000001100000000001    1
10000000000000001101010010001   101
110000011101010111110111100011   1
11110111 1110101 101111010001
11111111 1111111 111111111111