NO ./textures/n_wall.xpm
SO ./textures/s_wall.xpm
WE ./textures/w_wall.xpm
EA ./textures/e_wall.xpm

F 101,67,33
C 173,216,230

        111111111111111111111111111
        1000000000110000000000001
        1011000001110000000000001
        1001000000000000000000001
1111111110110000011100000000000N1
100000000011000001110111111111111
11110111111111011100000010001
11110111111111011101010010001
11000000110101011100000010001
10000000000000001100000010001    1
10000000000000001101010010001   101
110000011101010111110111100011   1
11110111 1110101 101111010001
11111111 1111111 111111111111