NO ./textures/stone.xpm
SO ./textures/cobbelstone.xpm
WE ./textures/obsidian.xpm
EA ./textures/bookshelf.xpm

F 220,100,0
C 225,30,12

XXXXXXXXXXXXXXXXXXXXXXXXXXXXXXXXXXXXX
X        111111111111111111111111111X
X        1000000000110000000000001  X
X        1011000001110000000000001  X
X        10010000000000000000W0001  X
X111111111011000001110000000000001  X
X100000000011000001110111111111111  X
X11110111111111011100000010001      X
X11110111111111011101010010001      X
X11000000110101011100000010001      X
X1000000000000001100000010001    1  X
X10000 00000000001101010010001   101X
X110000011101010111110111100011   1 X
X11110111 1110101 101111010001      X
X11111111 1111111 111111111111      X
XXXXXXXXXXXXXXXXXXXXXXXXXXXXXXXXXXXXX